11111111111111111111111111111111111
10000000000111100000000000000000001
10000000000111100000000000000000001
10001100000011000001100000000000001
10001100000000000001100000000000001
10001100000000000001100000000000001
10000000011111111000000000000000001
10000000000000000000000000000000001
10000110000000000000000000000000001
10000110011100011100000000000000001
11100110010000000100000000000000111
r000000001000000010000000000000000r
r000000001111111110000000000000000r
11100000000000000000000000000000111
10000000000000000000000000000000001
10000000000110000000000000000000001
10010000011111100000000000000001001
10010000000000000000000000000001001
10010000000000000000000000000001001
10011111000000000000000000011111001
10000000000011000000000000000000001
10000000000011000000000000000000001
10000000000000000000000000000000001
10000000000000000000000000000000001
11111111111111111111111111111111111