1111111111111111111111111
1000000000011110000000001
1000000000011110000000001
1000110000001100000110001
1000110000000000000110001
1000110000000000000110001
1000000001111111100000001
1000000000000000000000001
1000011000000000000000001
1000011001110001110000001
1110011001000000010000111
r00000000100000001000000r
r00000000111111111000000r
1110000000000000000000111
1000000000000000000000001
1000000000011000000000001
1001000001111110000001001
1001000000000000000001001
1001000000000000000001001
1001111100000000011111001
1000000000001100000000001
1000000000001100000000001
1000000000000000000000001
1000000000000000000000001
1111111111111111111111111